type octile
height 128
width 128
map
..................@@@@..........................................................................................................
..................@@@@@.........................................................................................................
...................@@@@@.@@.....................................................................................................
....................@@@@@@@@....................................................................................................
.....................@@.@@@@....................................................................................................
.......................@@@@.......@@............................................................................................
.......................@@@@......@@@@...........................................................................................
........................@@@@@....@@@@...........................................................................................
.........................@@@@@....@@@...................................................................................@@@@@@@@
..........................@@@@@....@................................................................................@@@@@@@@@@@@
...........................@@@@@....................................................................................@@@@@@@@@@@@
......@@@...................@@@@@...................................................................................@@@@@@@@@@@@
......@@@....................@@@@...................@@@@@@@@@@@@@@@@................@..................@@@@@........@@@@@@@@@@@@
......@.......................@.@...................@@@@@@@@@@@@@@@@..............@@@............@@@@@@@@@@@........@@@@@@@@@@@@
....................................................@@@@@@@@@@@@@@@@..............@@@...........@@@@@@@@@@@@........@@@@@@@@@@@@
....................................................@@@@@@@@@@@@@@@@...............@@...........@@@@@@@@@@@@........@@@@@@@@@@@@
@...........@.......................................@@@@@@@@@@@@@@@@...........@@@@@@@@@@@@@....@@@@@@@@@@@@@.......@@@@@@@@@@@@
@@.........@@.......................................@@@@@@@@@@@@@@@@.......@@@@@@@@@@@@@@@@@....@@@@@@@@@@@@@.......@@@@@.......
@@........@@@@......................................@@@@@@@@@@@@@@@@.......@@@@@@@@@@@@@@@@@.....@@@@@@@@@@@@...................
@@@.....@@@@@@@......................................@@@@@@@@@@@@@@@.......@@@@@@@@@@@@@@@@@.....@@@@@@@@@@@@...................
@@@@....@@@@@@@@.....................................@@@@@@@@@@@@@@@.......@@@@@@@@@@@@@@@@@.....@@@@@@@@@@@@...................
@@@@.....@@@@@@@.....................................@@@@@@@@@@@@@@@.......@@@@@@@@@@@@@@@@@.....@@@@@@@@@@@@...................
@@@@@....@@@@@@@@....................................@@@@@@@@@@@@@@@........@@@@@@@@@@@@@@@@...@@@@@@@@@@@@@@...................
@@@@@@....@@@@@@@@...................................@@@@@@@@@@@@@@@........@@@@@@@@@@@@@@@@...@@@@@@@@@@@@@@...................
@@@@.......@@@@@.....................................@@@@@@@@@@@@@@@........@@@@@@@@@@@@@@@@...@@@@@@@@@@@@@@...................
@@@.........@@@......................................@@@@@@@@@@@@@@@........@@@@@@@@@@@@@@@@...@@@@@@@@@@@@@....................
@...........@.....@@..................................@@@@@@@...............@@@@@@@@@@@@@@@@...@@@@@@@@@@@@@....................
.................@@@.......................................................@@@@@@@@@@@@@@@@@...@@@@@@@@@@@@@...........@@@@.....
...............@@@@@@......................................................@@@@@@@@@@@@@@@@@...@@@@@@@@@@@@@......@@@@@@@@@@@@@@
...............@@@@@@@.....................................................@@@@@@@@@@@@@@@@@...@@@@@@@@@@@@@......@@@@@@@@@@@@@@
...............@@@@@@@.....................................................@@@@@@@@@@@@@@@@@...@@@@@@@@@@@@@......@@@@@@@@@@@@@@
................@@@@@@@....................................................@@@@@@@@@@@@@@@@@...@@@@@@@@@@@@@.......@@@@@@@@@@@@@
.@.@............@@@@@@@@.................................................@@@@@@@@@@@@@@@@@@@...@@@@@@@@@@@@@.......@@@@@@@@@@@@@
@@@@............@@@@@@@@.................................................@@@@@@@@@@@@@@@@@@@@..@@@@@@@@@@@@@.......@@@@@@@@@@@@@
@@@@@............@@@@@@@@................................................@@@@@@@@@@@@@@@@@@@@..@@@@@@@@@@@@@.......@@@@@@@@@@@@@
@@@@@@...........@@@@@@@@@...............................................@@@@@@@@@@@@@@@@@@@@..@@@@@@@@@@@@@.......@@@@@@@@@@@@@
@@@@@@@...........@@@@@@@@................................................@@@@@@@@@@@@@@@@@@@...@@@@@@@@@@@@@......@@@@@@@@@@@@@
@@@@@@@............@@@@@@@@...............................................@@@@@@@@@@@@@@@@@@@...@@@@@@@@@@@@@......@@@@@@@@@@@@@
@@@@@@@............@@@@@@@@@..............................................@@@@@@@@@@@@@@@@@@@...@@@@@@@@@@@@@......@@@@@@@@@@@@@
@@@@@@@.............@@@@@@@@@.............................................@.@@@@@@@@@@@@........@@@@@@@@@@@@@...................
@@@@@@@@.............@@@@@@@@...................................................................@@@@@@..........................
@@@@@@@@@............@@@@@@@@@..................................................................................................
@@@@@@@@@.............@@@@@@@@@.................................................................................................
@@@@@@@@@@.............@@@@@@@@.................................................................................................
@@@@@@@@@@@.............@@@@@@@@................................................................................................
@@@@@@@@@@@.............@@@@@@@@@..........................@....................................................................
.@@@@@@@@@@@.............@@@@@@@@.@......................@@@@...................................................................
..@@@@@@@@@@@.............@@@@@@@@@.....................@@@@@@..................................................................
..@@@@@@@@@@..............@@@@@@@@@@...................@@@@@@@...........................................................@@@@@@@
...@@@@@@@@@@..............@@@@@@@@@@................@@@@@@@@@@...........................................@@@@@@....@@@@@@@@@@@@
....@@@@@@@@@@..............@@@@@@@@@...............@@@@@@@@@@@@....................................@@@@@@@@@@@@....@@@@@@@@@@@@
....@@@@@@@@@@..............@@@@@@@@@@..............@@@@@@@@@@@@.......................@@...........@@@@@@@@@@@@....@@@@@@@@@@@@
.....@@@@@@@@@@..............@@@@@@@@@@.............@@@@@@@@@@@@@.....................@@@@..........@@@@@@@@@@@@....@@@@@@@@@@@@
......@@@@@@@@@...............@@@@@@@@@..............@@@@@@@@@@@@@...................@@@@@@..........@@@@@@@@@@@....@@@@@@@@@@@@
......@@@@@@@@@@..............@@@@@@@@@...............@@@@@@@@@@@@@................@@@@@@@@..........@@@@@@@@@@@....@@@@@@@@@@@@
.......@@@@@@@@@...............@@@@@@@.................@@@@@@@@@@@@...............@@@@@@@@@@.........@@@@@@@@@@@....@@@@@@@@@@@@
........@@@@@@@@@...............@@@@...................@@@@@@@@@@@@.............@@@@@@@@@@@@@........@@@@@@@@@@@....@@@@@@@@@@@@
........@@@@@@@@@@...............@@.....................@@@@@@@@@@@@...........@@@@@@@@@@@@@@........@@@@@@@@@@@....@@@@@@@@@@@@
.........@@@@@@@@@@..............@.......................@@@@@@@@@@@@..........@@@@@@@@@@@@@@@.......@@@@@@@@@@@....@@@@@@@@@@@@
..........@@@@@@@@@......................................@@@@@@@@@@@@@.........@@@@@@@@@@@@@@@@......@@@@@@@@@@@@....@@@@@@@@@@@
..........@@@@@@@@.......................@@...............@@@@@@@@@@@@@.........@@@@@@@@@@@@@@@......@@@@@@@@@@@@....@@@@@@@@@@@
...........@@@@@@......................@@@@................@@@@@@@@@@@@..........@@@@@@@@@@@@........@@@@@@@@@@@@....@@@@@@@@@@@
............@@@......................@@@@@..................@@@@@@@@@@@@..........@@@...@@@@.........@@@@@@@.........@@@@@......
............@@.......................@@@..@@@...............@@@@@@@@@@@@@.........@@....@@...........@@@@.......................
........................................@@@@@................@@@@@@@@@@@@@......................................................
.........................................@@...................@@@@@@@@@@@@@.....................................................
...............................................................@@@@@@@@@@@@.....................................................
...............................................................@@@@@@@@@@@@@....................................................
................................................................@@@@@@@@@@@@@...................................................
.................................................................@@@@@@@@@@@@...................................................
.........................@@......................................@@@@@@@@@@..........................@..........................
........................@@@@......................................@@@@@@@@..........................@@@.........................
.......................@@@@@@....................@@................@@@@@@..........................@@@@.........................
.....................@@@@@@@@..................@@@@.................@@@..........................@@@@@@@........................
....................@@@@@@@@@@.................@@@..................@@..........................@@@@@@@@@.......................
...................@@@@@@@@@@@@.................................................................@@@@@@@@@@.................@@@@@
.................@@@@@@@@@@@@@@@................................................................@@@@@@@@@@............@@@@@@@@@@
..................@@@@@@@@@@@@@@.................................................................@@@@@@@@@@...........@@@@@@@@@@
...................@@@@@@@@@@@@...................................................................@@@@@@@@@@..........@@@@@@@@@@
...................@@@@@@@@@@......................................................................@@@@@@@@@@.........@@@@@@@@@@
....................@@@@@@@@.......................................................................@@@@@@@@@@.........@@@@@@@@@@
.......@.............@@@@@@.........................................................................@@@@@@@@@@........@@@@@@@@@@
......@@.............@@@@............................................................................@@@@@@@@@@.......@@@@@@@@@@
.....@@@@.............@@..............................................................................@@@@@@@@@@......@@@@@@@@@@
.....@@@@@.............................................................................................@@@@@@@@@......@@@@@@@@@@
......@@@@@............................................................................................@@@@@@@@@@.....@@@@@@@@@@
.......@@@@........................@@.....................@@@...........................................@@@@@@@@@@....@@@@@@@@@@
.......@@@@@.............................................@@@@@...........................................@@@@@@@@@@...@@@@@@@@@@
........@@@.............................................@@@@@@............................................@@@@@@@@@...@@@.......
......................................................@@@@@@@@@...........................................@@@@@@@@@@............
.....................................................@@@@@@@@@@@...........................................@@@@@@@@@@...........
.............................................@.....@@@@@@@@@@@@@............................................@@@@@@@@@@..........
............................................@@.....@@@@@@@@@@@@@@............................................@@@@@@@@@@.........
............................................@@@.....@@@@@@@@@@@@@@...........................................@@@@@@@@@@.........
............................................@@@@....@@@@@@@@@@@@@@............................................@@@@@@@@@@........
.............................................@@@.....@@@@@@@@@@@@@@............................................@@@@@@@@@@.......
..............................................@@@.....@@@@@@@@@@@@@@............................................@@@@@@@@@@......
...............................................@@.....@@@@@@@@@@@@@@............................................@@@@@@@@@@......
.......................................................@@@@@@@@@@@@@@............................................@@@@@@@@@@.....
........................................................@@@@@@@@@@@@@@............................................@@@@@@@@@@....
...............................................@@.......@@@@@@@@@@@@@@.............................................@@@@@@@@@@...
..............................................@@@@.......@@@@@@@@@@@@@@............................................@@@@@@@@@@...
............................................@@@@@@........@@@@@@@@@@@@@@............................................@@@@@@@@@@..
............................................@@@@@@@.......@@@@@@@@@@@@@@.............................................@@@@@@@@@@.
.............................................@@@@@@@.......@@@@@@@@@@@@@@.............................................@@@@@@@@@@
........................................@@@..@@@@@@@........@@@@@@@@@@@@@@.............................................@@@@@@@@@
.@....................................@@@@@@..@@@@@@@.......@@@@@@@@@@@@@@@............................................@@@@@@@@@
.@@............................@......@@@@@@...@@@@@@@.......@@@@@@@@@@@@@@.............................................@@@@@@@@
.......................................@@@@@@..@@@@@@@........@@@@@@@@@@@@@@.............................................@@@@@@@
.......................................@@@@@@@..@@@@@@........@@@@@@@@..@@@@@.............................................@@@@@@
........................................@@@@@@@@.@@@@@.........@@@@@@....@@@@.............................................@@.@@@
.........................................@@@@@@@.@@@@@@.................@@@@.................................................@@@
..........................................@@@@@@@@@@@@@@................@@...................................................@@@
..........................................@@@@@@@@@@@@@@@...............@......@@............................................@@@
...........................................@@@@@@@@@@@@@@.....................@@@.............................................@@
............................................@@@@@@@@@@@@@@..................@@@@@@.............................................@
............................................@@@@@@@@@@@@@@@................@@@@@@@@.............................................
.............................................@@@@@@@@@@@@@@..............@@@@@@@@@@.............................................
..............................................@@@@@@@@@@@@@@............@@@@@@@@@@@@............................................
.........@@@@.................................@@@@@@@@@@@@@@@..........@@@@@@@@@@@@@@...........................................
........@@@@@@@@...............................@@@@@@@@@@@@@@........@@@@@@@@@@@@@@.............................................
........@@@@@@@@................................@@@@@@@@@@@@@.......@@@@@@@@@@@@@@...@@.........................................
........@@@@@@@@................................@@@@@@..@@@@......@@@@@@@@@@@@@@...@@@@.........................................
............@@@@.................................@@@....@@.......@@@@@@@@@@@@@@....@@@@@........................................
................................................................@@@@@@@@@@@@@...@@@@@@@@@.......................................
..............................................................@@@@@@@@@@@@@@....@@@@@@@@@.......................................
.............................................................@@@@@@@@@@@@@@...@@@@@@@@@@@.......................................
...........................................................@@@@@@@@@@@@@@....@@@@@@@@@@@........................................
